................
................
.........CCC....
.........###....
................
...CCC.......CC.
...###.......##.
................
.1............X.
#########...####