................
................
.1.......CCC....
.#.......###....
......C.........
......#......CC.
...CC........##.
...##...........
..............X.
###.........####