................
................
.1.......CCC....
.#.......###....
......C....C....
......#......CC.
...CC........##.
...##...........
...C..........X.
###.........####