................
................
................
................
................
........C.......
........#.......
................
.1............X.
###...........##